1222222222229999999999999999999999999988
1222222222229999999999999999999999999988
1222222222229999999999999999999999999988
1222222222229999999999999999999999999988
12222222222299999999999999999999999999w8
12222222222299999999999999999999999999w8
12222222222299999999999999999999999999w8
1222222222229999999999999999999999999988
1222222222229999999999999999999999999988
1222222222229999999999999999999999999988
@222222222221111111111111111111111111111
@222222222221111111111111111111111111111
@222222222221111111111111111111111111111
@222222222221111111111111111111111111111
@222222222221111111111111111111111111111
@222222222221111111111111111111111111111
@222222222221111111111111111111111111111
8222222222221111111111111111111111111111
8222222222221111111111111111111111111111
8222222222221111111111111111111111111111
8222222222221111111111111111111111111111
@222222222221111111111111111111111111111
@222222222221111111111111111111111111111
@222222222221111111111111111111111111111
@222222222221111111111111111111111111111
9222222222221111111111111111111111111111
9222222222221111111111111111111111111111
9222222222221111111111111111111111111111
9222222222221111111111111111111111111111
@222222222221111111111111111111111111111
@222222222221111111111111111111111111111
@222222222221111111111111111111111111111
1111222222222221111111111111111111111111
1111222222222221111111111111111111111111
1111111222222222221111111111111111111111
1111111222222222221111111111111111111111
1111111222222222221111111111111111111111
1111111222222222221111111111111111111111
-
0,0,0
3,15,37,MMU.map,15,2
3,0,27,FCI_Building.map,54,15
3,38,5,DTC.map,2,25