0000000000112222222222222220000000000000
0000000000111111222222222220000000000000
0000000000111111222222222220000000000000
2222222222222222222222222220000000000000
2222222222222222222222222220000000000000
2222222222222222222222222220000000000000
2222222222222222222222222220000000000000
2222222222222222222222222220000000000000
2222222222222222222222222220000000000000
2222222222222222222222222220000000000000
2222222222222222222222222220000000000000
0000000000000008222222222220000000000000
0000000000000008222222222220000000000000
0000000000000008222222222220000000000000
0000000000000008222222222220000000000000
0000000000000008222222222220000000000000
0000000000000008222222222222220000000000
0000011000000008222222222222222222000000
0000000000000002222222222222222222222000
0000000000000000000000000022222222222000
0000000000000000000000000022222222222000
0000000000000000000000000022222222222000
0000000000000000000000000022222222222000
0000000000000000000000000022222222222000
0000110000000000000000000022222222222000
0000000000000000000000000022222222222000
0000000000000000000000000022222222222000
0000000000000077777777777722222222222000
0000000000000172222222222222222222222000
0000000000000072222222222222222222222000
0000000000000072222222222222222222222222
0000000000000072222222222700111111111111
0000000110000072222222222700000111100011
0000000000000074555555556700000000000000
-
0,2,1
3,20,33,HB2.map,20,2
4,1,1
3,18,0,road.map,18,38