0000000000000004555555556000000000000000
0000000000000004555555556000000000000000
0000000000000004555555556000000000000000
0000000000000004555555556000000000000000
1111111111111110000000000111111111111111
1111111111111110000000000111111111111111
1111111111111110000000000111111111111111
0000000000000000000000000111111111111111
0000000000000000000000000111111111111111
0000000000000000000000000111111111111111
1111111111111110000000000111111111111111
1111111111111110000000000222222222222222
1111111111111110000000000222222222222222
1111111111111110000000000222222222222222
1111111111111110000000000111111111111111
1111111111111110000000000111111111111111
1111111111111110000000000111111111111111
1111111111111110000000000111111111111111
1111111111111110000000000111111111111111
1111111111111110000000000111111111111111
1111111111111111111111111111111111111111
1111111111111111111111111111111111111111
1111111111111111111111111111111111111111
