99999999999999999999999999999999999999999999999999999999@
99999999999999999999999999999999999999999999999999999999@
99999999999999999999999999999999999999999999999999999999@
99999999999999999999999999999999999999999999999999999999@
99999999999999999999999999999999999999999999999999999999@
99999999999999999999999999999999999999999999999999999999@
999999999999999999999999999999999999999999999999999999998
999999999999999999999999999999999999999999999999999999998
999999999999999999999999999999999999999999999999999999998
9999999RhhhhhhhhhhhhhhhhhhhhhhhhhhhhhhhhhhL99999999999998
9999999sGGGGGGGGGGGGGGGGGGGGGGGGGGGGGGGGGGs9999999999999@
9999999sGGGGGGGGGGGGGGGGGGGGGGGGGGGGGGGGGGs9999999999999@
9999999sGGGGGGGGGGGGGGGGGGGGGGGGGGGGGGGGGGs9999999999999@
9999999sGGGGGGGGGGGGGGGGGGGGGGGGGGGGGGGGGGs9999999999999@
9999999sGGGGGGGGGGGGGGGGGGGGGGGGGGGGGGGGGGs99999999999999
9999999sGGGGGGGGGGGGGGGGGGGGGGGGGGGGGGGGGGs99999999999999
9999999sGGGGGGGGGGGGGGGGGGGGGGGGGGGGGGGGGGs99999999999999
9999999sGGGGGGGGGGGGGGGGGGGGGGGGGGGGGGGGGGs99999999999999
9999999sGGGGGGGGGGGGGGGGGGGGGGGGGGGGGGGGGGs9999999999999@
9999999sGGGGGGGGGGGGGGGGGGGGGGGGGGGGGGGGGGs9999999999999@
9999999sGGGGGGGGGGGGGGGGGGGGGGGGGGGGGGGGGGs9999999999999@
9999999sGGGGGGGGGGGGGGGGGGGGGGGGGGGGGGGGGGs99999999999991
9999999sGGGGGGGGGGGGGGGGGGGGGGGGGGGGGGGGGGs99999999999991
9999999sGGGGGGGGGGGGGGGGGGGGGGGGGGGGGGGGGGs99999999999991
9999999sGGGGGGGGGGGGGGGGGGGGGGGGGGGGGGGGGGs99999999999991
9999999sGGGGGGGGGGGGGGGGGGGGGGGGGGGGGGGGGGs99999999999991
9999999sGGGGGGGGGGGGGGGGGGGGGGGGGGGGGGGGGGs99999999999991
-
0,0,0
3,56,15,FCI.map,2,27
12,25,4,Edeline,Edeline64.png,edeline.npc
2,50,24,Madam Juliza,Juliza64.png,juliza.npc
2,30,5,Yu Xiang,YuXiang75.png,yuxiang.npc
2,5,2,Abang,security75.png,security.npc
19,20,0
