88888888888888888888888888888888888888888888888888888888
89999999999999999999999999999999999999999999999999999998
89999999999999999999999999999999999999999999999999999998
899999999999999999999$$$%$$$$$$$$$^$$9999999999999999998
89999999999999999999999999999999999999999999999999999998
89999999999999999999999999999999999999999999999999999998
89999999999999999999999999999999999999999999999999999998
89999999999999999999999999999999999999999999999999999998
89999999999999999999999999999999999999999999999999999998
89999999999999999999999999999999999999999999999999999998
89999999999999999999999999999999999999999999999999999998
89&&&&&9999999999999999999999999999999999999999999999998
88888888888888888888888999988999988888888888888888888888
-
0,24,11
3,25,12,MMU.map,17,24
8,29,1,HTC Boss,htcboss.png,htcboss.npc
9,41,9
9,41,10
9,41,5
9,41,6
9,41,1
9,45,9
9,45,10
9,45,5
9,45,6
9,45,1
9,49,9
9,49,10
9,49,5
9,49,6
9,49,1
9,53,9
9,53,10
9,53,5
9,53,6
9,53,1
9,1,4
9,3,4
9,5,4
9,1,8
9,3,8
9,5,8
10,6,10,Fazir,Fazir64.png,fazir.npc