0000000000000074555555556700000000000000
0000000000000074555555556700000000000000
0000000000000074555555556700000000000000
3333333333333334555555556333333333333333
1111111111111112222222222111111111111111
1111111111111112222222222111111111111111
1111111111111112222222222222222211111111
1111111111111112222222222222222211111111
8111111111111112222222222111112222222222
8111111111111112222222222111112222222222
8111111111111112222222222111111111111111
8222222222222222222222222111111111111111
8222222222222222222222222111111111111111
8222222222222222222222222111111111111118
8111111111111112222222222111111111111118
8111111111111112222222222111111111111118
8111111111111112222222222111111111111118
8111111111111112222222222111111111111118
8111111111111112222222222111111111111118
8111111111111112222222222111111111111118
8111111111111112222222222111111111111118
8111111111111112222222222111111111111118
8111111111111112222222222111111111111118
-
0,15,15
1,9,11
2,15,11,Fat Guy,fatguy.png,FatGuy.npc
3,20,0,HB3.map,20,31