000000000011222222222222222111111111111Y
0000000000112222222222222221111111111111
0000000000111111222222222221111111111111
0000000000111111222222222221111111111111
2222222222222222222222222221111111111111
2222222222222222222222222221111111111111
2222222222222222222222222221111111111111
2222222222222222222222222221111111111111
2222222222222222222222222221111111111111
2222222222222222222222222221111111111111
2222222222222222222222222221111111111111
2222222222222222222222222221111111111111
1111000000011108222222222221111111111111
Y000000000000Y08222222222221111111111111
0000H00000000008222222222221111111111111
1110000000000008222222222221111111111111
0000000000O11008222222222221111111111111
0H000000000B0008222222222222220000000000
0000011000000008222222222222222222000000
00B0000001100002222222222222222222222000
0000O00000000000000000000022222222222000
0Y0000000000000Y000000000002222222222200
00000000H0000000000000000022222222222000
00H00000000Y0000Y00000000022222222222000
0000110000000000000000011122222222222000
0000000000B0000B0B0000000022222222222000
0011100000000000000011100022222222222000
000000H000000077777777777722222222222000
0000000000000172222222222222222222222000
000B00000B000072222222222222222222222000
00H0000000000072222222222222222222222222
0Y00000000000072222222222700111111111111
0000000110000072222222222700000111100011
H00000000000007455555555670000000000000B
-
0,2,1
3,20,33,HB2.map,20,2
4,1,1
3,18,0,road.map,18,38
14,0,0,X.map,5,7
2,18,5,Aik Sheng,Aiksheng64.png,aik.npc
2,31,18,Wei Hang,weihang75.png,weihang.npc
2,15,7,???,F64.png,f.npc
23,2,10
1,20,10