1111111222222222221111111111111111111111
1111111122222222222111111111111111111111
1111111112222222222211111111111111111111
1111111111222222222221111111111111111111
1111111111122222222222111111111111111111
1111111111112222222222211111111111111111
1111111111111222222222221111111111111111
1111122222222222222222221111111111111111
9999999999999222222222221111111111111111
9999999999999222222222221111111111111111
9999999999999222222222221111111111111111
9999999999999222222222221111111111111111
9999999999999222222222221111111111111111
9999999999999222222222221111111111111111
9999999999999222222222222222222222222222
9999999999999222222222222222222222222222
9999999999999222222222221111111111111111
9999999999999222222222221111111111111111
9999999999999222222222221111111111111111
9999999999999222222222221111111111111111
9999999999999111222222221111111111111111
9999999999999111222222221111111111111111
9999999922222111222222221111111111111111
9999999922222111222222221111111111111111
9999999922222111222222221111111111111111
9999999922222111222222221111111111111111
9999999922222222222222221111111111111111
9999999922222222222222221111111111111111
9999999922222222222222221111111111111111
1111111111111111222222221111111111111111
1111111111111111222222221111111111111111
1111111111111111222222221111111111111111
1111111111111111222222221111111111111111
1111111111111111822222222811111111111111
1111111111111111822222222811111111111111
-
0,20,20
3,18,34,road.map,18,2
3,15,0,FCI.map,15,35
3,15,26,Haji_Tapah.map,23,11
3,12,12,Learning_Point.map,67,17
5,0,22
6,0,1
2,20,20,Barbie,Barbie64.png,barbie.npc
1,20,23