1111111111111111822222222811111111111111
1111111111111118222222228111111111111111
1111111111111182222222281111111111111111
1111111111111822222222811111111111111111
1111111111118222222228111111111111111111
1111111111182222222281111111111111111111
1111111111112222222221111111111111111111
1111111111112222222221111111111111111111
1111111111112222222221111111111111111111
1111111111112222222221111111111111111111
2222222222222222222221111111111111111111
2222222222222222222221111111111111111111
1111111111112222222221111111111222222222
1111111111112222222221111111111222222222
1111111111112222222221111111222221111111
1111111111112222222221111111222221111111
1111111111112222222221111222221111111111
1111111111112222222221111222221111111111
1111111111112222222221122221111111111111
1111111111112222222221122221111111111111
1111111111112222222222222111111111111111
1111111111112222222222222111111111111111
1111111111112222222221111111111111111111
1111111111112222222221111111111111111111
1111111111112222222221111111111111111111
999999999999!!!!!!!!!9999999999999999999
###999###999!!!!!!!!!999###999###999###9
999999999999!!!!!!!!!9999999999999999999
############!!!!!!!!!###################
999999999999!!!!!!!!!9999999999999999999
###999###999!!!!!!!!!999###999###999###9
999999999999!!!!!!!!!9999999999999999999
1111111111182222222228111111111111111111
1111111111182222222228111111111111111111
1111111111182222222228111111111111111111
1111111111182222222228111111111111111111
1111111111182222222228111111111111111111
1111111111182222222228111111111111111111
1111111111182222222228111111111111111111
1111111111112222222221100011111111010111
0000000000112222222222222220000000000000
-
0,0,0
3,18,40,HB3.map,18,2
3,18,0,MMU.map,18,32
7,25,26
2,25,31,Ivan,Ivan64.png,ivan.npc
2,17,10,Terrence,Terrence75.png,terrence.npc
1,10,10
24,8,20
24,8,15
24,20,15
24,20,10
24,29,5